NO ./textures/wall_4.xpm
SO ./textures/wood.xpm
EA ./textures/mossy.xpm
WE ./textures/colorstone.xpm

C 182,182,1
F 0,0,255

	11111111111111
	10000000000001
	10000000000001
	10000000000001	1
	1000E000000001
	10000000000001
	10000000000001
	11111111111111