NO  ./textures/wall_4.xpm
SO ./textures/wood.xpm
EA ./textures/mossy.xpm
WE ./textures/colorstone.xpm

C 225,30,0
F 220,100,0


        11111111111111111111111111111111
        100000000011000001     100000001
        10110000011100000011111111111111
        1001000000000000000000001
111111111011000001110000000000001
100000000011000001110111111111111
11110111111111011100000010001
11110111111111011101010010001
11000011111111111100000010001
1000001         1000110000W1111
1000001        110101000001
1100000111   1101111101111011111
11110111111111011101111010001
11111111 1111111 111111111111