NO  ./textures/wall_4.xpm
SO ./textures/wood.xpm
EA ./textures/mossy.xpm
WE ./textures/colorstone.xpm

F 0,0,255
C 182,182,0

111111111111111111
100000000000000001
100000000000000001
1000W0000111111111
1000000001
1000000001
1100000111
1111011111
111101111111111111
100000000000000001
100000000000000001
100010000111111111
1000000001
1000100001
1100000111
1111111111