NO  ./textures/wall_4.xpm
SO ./textures/wood.xpm
EA ./textures/mossy.xpm
WE ./textures/colorstone.xpm

F 0,0,255
C 182,182,0

11111111111111
10000000000001
10000000000001
10000000000001
100100W0000001
10000000000001
10000010001001
10000000000001
11111111111111