NO  ./textures/mur.xpm
SO ./textures/SO.xpm
WE ./textures/WE.xpm
EA ./textures/EA.xpm

F 0,0,255
C 182,182,0

1111111111
1000000001
1000000001
1000S00001
1000000001
1000000001
1100000111
1111111111