NO  ./textures/wall_4.xpm
SO ./textures/wood.xpm
EA ./textures/mossy.xpm
WE ./textures/colorstone.xpm

F 0,0,255
C 182,182,0

            11111111
         111100001
111111111100000011
1110000011111111
  1000000011
1110000001
11000E0111
1111001111
111101111111111111
100000000000000001
100000000000000001
100010000011111111
1000000001
1000100001
1100000111
1111111111