NO  ./textures/wall_4.xpm
SO ./textures/wood.xpm
EA ./textures/mossy.xpm
WE ./textures/colorstone.xpm

F 0,0,255
C 182,182,0

1111111111111111111
1000000011111101111
1000000011
11100000011
1100000111
1111001111
111101111111111111
100011110000000001
10001  10000000001
10001  10000000001
100011110000000001
100000000111111111
1000100001
1100000111
1111111111