NO ./textures/wall_4.xpm
SO ./textures/wood.xpm
EA ./textures/mossy.xpm
WE ./textures/colorstone.xpm

F 0,0,255
C 182,182,0

111111111111111111111111111111111111111111111111111111111111
100000000000000000000000000000000000000000000000000000000001
100000000000000000000000000000000000000000000000000000000001
100000000000000000000000000000000000000000000000000000000001
100000000000000000000000000000000000000000000000000000000001
100000000000000000000000000000000000000000000000000000000001
100000000000001111111111111000000000011111111111100000000001
100000000000001111111111111000000000011111111111100000000001
100000000000001111111111111000000000011111111111100000000001
100000000000001111111111111000000000011111111111100000000001
100000000000001111111111111000000000011111111111100000000001
100000000000000000000000000000000000000000000000000000000001
10000000000000000000000000000110N000000000000000000000000001
100000000000000000000000000001   0000000000000000000000000001
111111111111111000000000000001   000000000000000000000000001111111111111111
              100000000000001111111111111000000000011111111111100000000001
              100000000000001     100000000001111111111110000000000111111111111
              100000000000001     1000000000011111111111100000000001
              100000000000001     100000000001111111111110000000000111111111111
              100000000000000111111111111000000000011111111111100000000001
              100000000000000000000000000000000000000000000000000000000001
              100000000000000000000000000000000000000000000000000000000001
              100000000000000000000000000000000000000000000000000000000001
              100000000000000000000000000000000000000000000000000000000001
              100000000000000000000000000000000000000000000000000000000001
              111111111111111111111111111111111111111111111111111111111111